+-+-+-+-+-+-+-+-+-+-+-+-+-+-+-+-+-+-+-+-+-+-+-+-+-+-+-+-+-+-+-+-+-+-+-+-+-+-+-+-+-+-+-+-+-+-+-+-+-+-+
  |   | | | |   |   |   |     |   |   |   |         |     |   |   | | |       | |   | |     |   |   |
+ + +-+ + + +-+ +-+ +-+ + +-+ +-+ + +-+ + +-+ +-+-+-+ + + + +-+-+ + + +-+ +-+-+ +-+ + +-+-+ + +-+ +-+
|         | |         | |   | | | | |   | |   |       | | |       |           |             |     | |
+-+-+ +-+ + + + +-+ + + + + +-+ + + +-+ +-+-+ +-+ + + +-+-+-+-+ +-+ +-+ +-+ + +-+ +-+ + + + +-+ + + +
| |   |       |   | |   | |     |     |   |       | |     |   |   |   |   | |   |   | | | |     |   |
+ +-+-+ +-+-+-+ +-+-+ +-+-+-+ + +-+ + +-+ + +-+ +-+ +-+ +-+-+ + +-+ +-+ + +-+-+ + +-+ +-+-+ +-+-+-+ +
| |   | |       |   | | |     | | | |   | |   | |   |     |         |   |     |   |       | | | |   |
+ + + +-+-+-+-+ +-+ +-+ + +-+ +-+ +-+ +-+ +-+-+-+ +-+-+-+-+-+ +-+ + +-+-+ +-+-+ +-+-+ +-+ + + + +-+ +
|   |     |   |   | |   | |   |   |         |     |   | | |   | | |   |     | |     |   | | |   | | |
+-+-+ +-+-+-+ +-+ + +-+ + +-+-+ +-+ + + +-+ +-+ +-+ + + + +-+-+ +-+-+-+ +-+ + +-+ +-+-+ + + +-+ + + +
|         |   | | | | |     |     | | | |   | |     |   |     |       | | | | |   | | | | | |   |   |
+-+ +-+ + +-+ + + + + + + +-+ +-+-+-+-+-+ + + + + +-+-+-+ +-+-+ + + +-+ + + + +-+-+ + +-+-+-+-+ +-+-+
|   |   |     |   | |   |           |     |     | |             | |     |   |   |         |   |   | |
+ +-+-+-+-+-+-+-+ + + +-+-+-+-+-+-+-+-+ + +-+-+-+-+-+ + + + + +-+ + + + +-+-+ + +-+-+-+ +-+-+ +-+ + +
|     | |   | |         |     |   | |   | |     |     | | | | |   | | | |   | |     |     |   |     |
+ + + + + +-+ + + +-+ +-+-+-+ + +-+ +-+-+ + +-+-+-+ +-+ +-+ +-+ + +-+-+-+-+ +-+-+ + +-+ +-+ + +-+ +-+
| | |     | |   | | |   | |       |             | | | |   | | | | |       | | | | |         |       |
+-+ +-+-+-+ + +-+ + +-+ + +-+-+-+ +-+-+ + +-+ + + + + +-+-+-+ + +-+-+-+ +-+ + + + +-+ + +-+ + +-+ + +
|     | | |     |   |   |       | |     |   | |         |         |     |   |     | | | | | | | | | |
+-+ +-+ + + +-+-+-+ +-+-+ + +-+-+ + + + + +-+-+-+ + +-+ +-+-+ + +-+-+ +-+ + + + + + +-+-+ +-+ + + +-+
|       |         | |   | |     |   | | |   |     |   | |   | |   |   | | |   | | |       |   |   | |
+ +-+ +-+ + + +-+-+ + +-+-+-+ +-+-+ +-+-+ +-+ +-+-+-+ + +-+ +-+ + + +-+ +-+ + +-+-+-+ +-+ +-+-+-+-+ +
|   |     | |   |   |     |   | |     | |   | | |     | | |     |           |       |   |       |   |
+ +-+ +-+ +-+ +-+ +-+ +-+ + + + + +-+-+ + +-+-+ +-+ +-+ + +-+ +-+ +-+ +-+ +-+ +-+-+ + +-+-+ + +-+ +-+
| |   |   |     |     |     |         |       | | |   | |       | |     | | | | |   |     | | | | | |
+-+-+ +-+-+ +-+-+ + + +-+ +-+-+-+-+-+-+ +-+ +-+ + + +-+-+ +-+-+-+-+-+ + +-+ +-+ + +-+ +-+ +-+ + + + +
|     |     |     | |   |     |         |   |     | | |   |   |     | | | |   |       | | |   |     |
+-+ + +-+-+-+ +-+ +-+ + +-+-+ +-+-+ +-+-+-+-+ +-+-+-+ + +-+ +-+ +-+-+ +-+ + +-+ + + +-+ + +-+-+ +-+-+
|   | | |     |   |   | | |     |     |     | | |             |         |   |   | | | |   | |       |
+-+ +-+ + +-+ +-+ +-+-+-+ + +-+ +-+ +-+ +-+ + + +-+-+-+ +-+-+ +-+-+ +-+-+-+ +-+ +-+-+ +-+-+ +-+ +-+-+
|     |     | |   |   | |     | |       | |       |     |   |   |   |     |   |           |   |     |
+-+-+ +-+ + +-+-+-+-+ + + + +-+-+-+ + +-+ + + + + +-+ + + +-+-+-+-+-+ +-+-+ +-+ +-+-+ +-+-+-+ + +-+ +
|   | | | | |   |         | | |     | |   | | | |   | | |   | | | |     |   | | |           | | | | |
+ +-+ + +-+ +-+ + + + +-+-+-+ + + + + + + +-+ +-+ + +-+-+ +-+ + + + +-+-+ +-+ +-+-+-+ +-+-+ + + + +-+
|         | | | | | | |   |   | | | |   |   | | | | | |               | |     |   | |     | |     | |
+-+ + +-+-+ + + +-+ +-+ + + +-+ +-+ +-+-+-+-+-+ +-+ + +-+ + +-+ +-+ +-+ +-+ +-+ +-+ +-+-+-+ + + + + +
|   |     |     | |   | | |   | |     | | |   |       | | | |   |   |   |   | |       | | | | | |   |
+ + +-+ + + +-+-+ +-+-+ +-+ +-+-+ + +-+ + +-+ +-+ + +-+ +-+-+-+ +-+-+ + +-+ + + +-+ +-+ + + +-+-+ +-+
| |   | | |     |     | |     |   |     |       | | |           |   | | | |     |     |       | |   |
+ + +-+ +-+ + +-+-+ +-+ +-+ +-+-+-+ + +-+ +-+ +-+-+ +-+ + +-+-+ +-+ + + + +-+ + +-+-+-+-+ +-+ + +-+ +
| | | | |   | |   |   |   |       | |   | |           | |   |     | | |       | | |   | | |     |   |
+ + + +-+-+-+ + +-+ +-+ + +-+-+ + +-+-+ +-+-+ +-+-+ + + + +-+ + + + +-+ + +-+ + + +-+ + +-+-+-+ + +-+
| | |   |   |   |   |   |       |           |   | | | | | | | | | |   | | |   | | |   | | |         |
+-+-+-+ + + +-+-+ +-+-+-+ +-+ +-+-+-+ +-+-+-+ +-+ +-+ +-+ + +-+-+-+ +-+ + +-+-+-+ +-+ + + + +-+-+ + +
|   |     | |           |   |   |   |   | |   |     | |                 |         | |   |       | | |
+ + +-+-+ + +-+ +-+-+-+-+ + + + + +-+-+-+ + + +-+-+ +-+-+ +-+ +-+-+ +-+-+-+ +-+-+ + + +-+ +-+-+-+-+ +
| |       |   |   | |   | | | | |     |     | |           |   |   |   | |       | |   |         |   |
+ +-+ +-+-+-+ + + + + +-+-+-+ +-+-+-+ + +-+-+ +-+-+-+ +-+ + +-+-+ + + + +-+ + +-+ +-+ +-+ +-+-+ +-+-+
|   |     |     | | |       | | |     |     | |     |   | | |   |   |   |   | | |     |   |     | | |
+ +-+ + +-+-+-+-+ + +-+ +-+ + + + + +-+-+-+-+ + + + +-+-+ +-+-+ +-+-+-+ +-+-+ + +-+-+-+-+ + + +-+ + +
| | | |         |     | |     |   |   |     |   | | |   |       |   |   |   | |   | | | | | |       |
+ + + + +-+ + +-+ +-+ +-+ +-+-+-+ +-+ + +-+ +-+ +-+ + +-+-+-+-+-+-+ +-+-+ + + + +-+ + + + +-+-+-+ +-+
|   | |   | | |     |   | |         | |   |       |   | |             | | |           |       |     |
+ +-+-+ + +-+-+-+ +-+-+ + +-+-+ + +-+ + + +-+ +-+-+-+ + +-+ + +-+-+-+ + +-+ +-+ +-+-+ +-+ + +-+-+ +-+
| |   | | |       |   | | | |   |   | | | |   |           | | | |       |   |       |     |   | |   |
+ + +-+-+-+-+-+ +-+ +-+ + + +-+ +-+-+-+ +-+-+ + +-+ + + +-+-+ + +-+-+-+ +-+-+ +-+-+ +-+ +-+-+ + +-+ +
| | | |     |   |         |     | |     | |   | |   | | |   |   | |           |       | | |       | |
+ + + + +-+ + +-+-+ +-+ +-+ +-+ + + +-+ + + +-+-+ +-+ +-+ + +-+ + + + + + + + +-+-+-+ + + +-+ +-+ +-+
|     | |         |   |       |   |   | |     |     |     | |   |   | | | | |       | | |       |    
+-+-+-+-+-+-+-+-+-+-+-+-+-+-+-+-+-+-+-+-+-+-+-+-+-+-+-+-+-+-+-+-+-+-+-+-+-+-+-+-+-+-+-+-+-+-+-+-+-+-+
