+-+-+-+-+-+-+-+-+-+-+-+-+-+-+-+
    | |   |   |   |   | |     |
+-+ + + +-+-+ +-+ + + + +-+ + +
|       |   |   |   |     | | |
+-+ +-+-+ +-+-+ + +-+-+-+-+-+ +
|         |     | | | |       |
+-+ +-+ +-+-+ +-+ + + +-+ +-+ +
|   | | | |   | |   | |     | |
+ + + +-+ + + + +-+ + +-+ +-+-+
| |         |   | |         | |
+ +-+-+ +-+-+ + + + + +-+-+ + +
|     | |     | | | | | |     |
+-+-+ + +-+ +-+-+ + +-+ + + +-+
|   | | |       |     | | |   |
+ +-+ +-+-+-+ +-+ +-+ + +-+-+-+
|     | |           |     |   |
+ + + + + +-+ + +-+-+ + +-+ +-+
| | |   | | | |     | |   | | |
+ + +-+ + + +-+-+-+ +-+-+ + + +
| |   | |     |     |          
+-+-+-+-+-+-+-+-+-+-+-+-+-+-+-+
