+-+-+-+-+-+-+-+-+-+-+-+-+-+-+-+-+-+-+-+-+-+-+-+-+-+-+-+-+-+-+-+-+-+-+-+-+-+-+-+-+-+-+-+-+-+-+-+-+-+-+-+-+-+-+-+-+-+-+-+-+-+-+-+-+-+
  |   | |   |   |   |   | | | | |   | |       |   |         |     |   | | |     | | |       | | | |       | |   |   |     |       |
+ + + + + +-+-+ + +-+-+ + + + + + +-+ +-+ +-+ +-+ +-+ + +-+-+-+ +-+ +-+ + + +-+-+ + + +-+ +-+ + + +-+ + +-+ + +-+ +-+-+ + + +-+-+-+
|   |   | |   |   |   | |               | |       |   | | |     |         |   | |     |           |   |     | |   |     | |     | |
+-+-+-+ + + +-+ +-+-+ + +-+ +-+ +-+-+ +-+-+-+ +-+-+ +-+-+ + +-+ +-+-+-+ +-+-+ + +-+-+-+ +-+ +-+-+ + + + +-+-+ + +-+-+-+-+ +-+ + + +
|   | |     |       |   | |   | |     | |               |     |     |   | | |     |     | |     | | | |   | | |               |   |
+-+ + + + +-+-+ +-+-+-+ + + +-+-+-+-+-+ +-+ +-+ + + + + + +-+ + +-+-+-+ + + +-+-+ +-+-+-+ +-+-+-+ +-+-+ + + + + +-+ +-+-+-+ + +-+ +
|       | | | |   |       | | | |   | |   |   | | | | |   | | | |   |       | |               |         |       |   | |     | | | |
+-+-+-+ + + + + + +-+-+-+ + + + +-+ + + + +-+-+-+-+ + +-+ + +-+-+ + +-+-+ +-+ + +-+-+-+-+ +-+-+ +-+ + +-+-+ + + +-+-+ +-+ +-+ + +-+
| |     |     | | | |           |     | |     | |   | | |   |     | |   |   |         |         |   |   | | | |   |   |     |     |
+ +-+-+-+ + + + + + + +-+ +-+-+ +-+ +-+ +-+-+ + +-+-+-+ +-+ + +-+-+-+ +-+ +-+-+ +-+-+ + + +-+ +-+ +-+-+ + + +-+-+-+ + + +-+-+ +-+ +
| | |   | | | | | |     | |     |     |   |   | | |   | | | |   |   |               | | | |     | |     | |         | | |     |   |
+ + + + + +-+ + + +-+-+-+-+ +-+ + +-+-+-+-+-+ + + + +-+ + + +-+ + + +-+-+-+ +-+-+-+-+ + +-+-+-+ +-+-+-+-+ + + +-+-+-+-+-+ +-+ + +-+
| |   | |   |   | | |   |     | | |     |     |       |   |       | |   |   | |     | |     |   | |     | | |   |       | | | | | |
+ + + + +-+-+ + + + + + + +-+-+ + +-+-+ + + +-+-+-+ +-+ +-+ +-+-+ + + + + + + +-+ +-+-+-+ + +-+ + + + +-+ +-+ +-+ +-+-+-+-+ +-+-+ +
|   | | |   | | |     |   |       |   |   | |   |           | |   |   | | | |           | |   | |   |   | |   | |     |           |
+ +-+-+ + +-+ +-+-+ +-+ + + + +-+ + +-+-+ + + +-+-+ +-+-+ +-+ +-+ +-+ + +-+ + +-+-+-+-+-+ + + +-+ +-+-+ + + +-+ + +-+-+-+-+-+ +-+ +
|     |     | |   |   | | | | | | | | |   | |   | |   |       |     | |   | |           | | | |   | |   |   |     | |           | |
+-+-+ + +-+-+-+ +-+ +-+-+ +-+ + + + + + +-+-+-+ + +-+-+-+-+-+-+ +-+ +-+-+ +-+ +-+ +-+-+ +-+ + +-+ + + +-+-+-+-+-+ + +-+ + +-+ + +-+
|     | |   |         | |   | | |   |       |     |           | | | |   | | | |     |     | | | | |   | | |   | |     | |   | |   |
+ + + + +-+ + +-+ + + + +-+ + + + +-+-+ +-+ +-+ +-+ +-+-+-+ + + + +-+-+ +-+ + + +-+ + +-+-+-+ + +-+ +-+ + +-+ + +-+ + + + +-+ +-+-+
| | | |       |   | |   | | | |         | |     | | |     | | | |   | |   |   | | | | |     |   |     | | |   |   | |   | | |     |
+ +-+ + +-+-+ + + +-+-+-+ +-+ +-+-+ +-+ + + + + + + + + + + +-+ + +-+ + +-+-+-+-+ + + + +-+ + +-+ + +-+ + + + + + +-+ +-+-+ + +-+ +
|   | | |     | | | |     |   |   |   |   | | |   | | | | | | |   |     |     |     | |   |   |   |   |     | | |   |     |   |   |
+-+-+-+-+-+-+ +-+-+ + +-+ +-+-+ +-+ +-+-+ +-+ +-+ +-+ +-+-+ + +-+ + + + + + + +-+-+ + +-+ +-+-+ +-+-+ + +-+ + + +-+-+ +-+-+-+ +-+ +
| |   |       |     | |           |   |   | |   | | |     |   |     | | | | | | | | |       | |     | |   | | |   |   |     | |   |
+ +-+ + + +-+ + +-+-+ + + +-+ +-+ +-+-+ +-+ + + + + + +-+-+-+ +-+-+-+-+ + + + + + +-+ +-+-+ + + + +-+ + +-+ +-+ +-+ + +-+ + +-+ +-+
|   | | | | | | |     | | |   |   | | |   |   | |               |       | | |           | |   | | |   | |   |       |     | | |   |
+-+ + +-+ + + + + +-+-+ + + + +-+-+ + + +-+-+-+-+-+-+-+ +-+-+ +-+ +-+ + +-+ +-+-+-+-+ +-+ + + +-+-+ + + +-+-+-+-+-+ + + +-+-+ +-+ +
|         | |       |   | | |     |     |           |   | | | |   |   | |     | | | | | | | |   | | |     |     | | | | |   |     |
+-+ + +-+ + + +-+-+-+ +-+ + +-+-+ +-+ + + +-+ + +-+ +-+ + + +-+ +-+ +-+-+-+ + + + + + + + + + + + + +-+ +-+ +-+-+ +-+ + +-+ +-+ +-+
| | | |     |   |   | | | | |   | |   |     | | |     |   |       |         | | | |   |     | | |   |       | |   |   | |   |   | |
+ + + + +-+-+-+-+ +-+ + + +-+ + +-+-+-+ + +-+-+ +-+ +-+-+-+-+-+-+-+-+ +-+-+-+ + + + +-+ + + + +-+ +-+ +-+ +-+ + +-+-+ +-+ +-+-+-+ +
|   | |   |   | |     |     | |     |   |     | |       | |   | |         |   |     | | | | |   |   | | |     |   | |         |   |
+-+-+-+ +-+-+ + + +-+-+ +-+-+-+-+-+ + +-+ +-+-+-+-+ +-+ + + +-+ +-+-+-+-+ +-+-+-+-+ + +-+-+-+-+-+-+-+-+ +-+ +-+-+ + + +-+-+ +-+ + +
|     |   |   |   | |   |       |   | |       |     |   |     | |   |       |             |   |               |   |       |     | |
+ +-+ +-+ + + +-+-+ + + +-+-+ +-+-+ + +-+-+-+-+-+ +-+-+ + +-+ + + +-+-+ +-+ + +-+-+ +-+-+ +-+ + + +-+-+-+-+-+-+ +-+ +-+-+ +-+-+-+ +
|   | |     | | | |   | |   | |   |       | |     |   |   |   |     | |   | |   | |     |   |   |   | |   |       |   | |     |   |
+ + +-+ + +-+-+ + +-+-+-+ + + +-+ + +-+ + + + + +-+-+ +-+-+ +-+ +-+-+ + +-+-+-+ + +-+ +-+ +-+-+ + +-+ +-+ + +-+ +-+ +-+ + + +-+-+-+
| |   | |         |   |   | |         | | |   |   |   |     | |       | |           |   |     | |   |         | |   |     |   |   |
+-+-+ + +-+-+-+ +-+ +-+ + + + +-+-+-+-+-+-+ +-+-+ + +-+-+-+-+ +-+-+ +-+-+-+ + +-+ +-+ +-+ +-+ +-+ + +-+-+ +-+-+ +-+ +-+-+ +-+ +-+ +
| |   |   | |     |   | | | | | |   |   |   |         |       |     |       | |   |   | | |       | |     | |   |   |   | |       |
+ +-+ + +-+ +-+ +-+-+ +-+-+ + + +-+ + + +-+ +-+-+-+ + +-+-+-+ +-+ +-+-+ + + +-+-+-+ + + +-+-+ +-+-+-+ +-+-+ +-+ +-+-+ + + +-+-+ +-+
|     |     |           | | | |   | | | | | | |     |   |   |   |   |   | |   |   | |   |   | |   |   |   | |   | |   |     |     |
+ +-+ +-+ + + +-+-+ + +-+ + + +-+ + +-+ + + + + +-+ +-+ + +-+ + + +-+-+-+ + + + +-+ +-+ + +-+ + + + + +-+ + + +-+ + +-+-+ +-+ + +-+
| | | |   | | |   | |   |     | |     | | | |   | | | | |     | | |       | | |   |   | |       | | | |   | | | | |   |     | |   |
+ + +-+-+ +-+-+ +-+ +-+ +-+ +-+ + + + + + +-+-+-+ +-+ +-+-+ +-+-+ + +-+ +-+-+ + + + + +-+ +-+ +-+-+-+ +-+ + +-+ + + +-+-+ +-+-+-+ +
| |   |   | |       | |   |   |   | | | |   |   |         |   |       |   |   | |   | | | |   |     |   |   | |         |   |   | |
+ + +-+-+-+ + + +-+-+ + + + +-+-+-+ +-+ +-+ + + +-+-+-+ +-+ +-+-+ + +-+-+-+-+-+ + +-+ + + +-+ + +-+-+ + +-+ + +-+-+ +-+-+ +-+ +-+ +
|       |   | |   | |   | | |     | |     | | |   | |     |     | |   |       | | | | |   | |     |   |     |     |   |     |     |
+ +-+ + + + +-+-+ + +-+-+-+ + +-+ + +-+ +-+ +-+-+ + + +-+-+ +-+-+ +-+ +-+ + +-+-+-+ +-+-+ + +-+-+-+ +-+ +-+ + +-+-+ +-+ +-+-+-+ + +
| |   |   |       | |   |     |   | | |       |   |     | |   |     |   | |     |       |     |   |   | |       |     |   | |   | |
+ +-+-+ +-+-+ +-+-+ + +-+-+ +-+ + + + + +-+-+ + +-+-+ +-+ +-+ + + +-+ +-+ +-+ + + + + +-+-+-+ +-+ +-+ + +-+-+-+ + +-+ +-+ + +-+ +-+
| |       |   |   | | |   |   | |     |   | | | |     |   |   | | |       |   | | | |                 | |     |   | |   | | |   | |
+ +-+ + + +-+-+ +-+ + + + + + + + +-+-+ +-+ + + +-+ + +-+ +-+ + +-+-+-+-+ +-+ +-+-+-+ +-+-+ +-+-+-+-+ +-+-+ +-+ +-+ +-+ +-+ + + + +
| |   | | |             |   | | |           | | |   |     |   | | |   | | | | |     |   | | |     | | | |       |   |   |   | |   |
+-+-+ +-+-+-+-+ +-+ +-+ + +-+ + +-+ +-+-+ + +-+ +-+-+-+ + + + + + + +-+ + + + + +-+-+ +-+ +-+ + + + +-+ + +-+ + + + +-+-+-+ + + +-+
|     |   |     |   | | |   | |   |   |   |   |       | |   | |       |     | |     | |     | | | |   |   |   |   | |   |     |   |
+-+-+-+-+ +-+-+ + + + +-+-+-+-+-+-+-+-+-+ +-+-+-+ +-+ + + + +-+ + +-+-+-+-+-+ +-+ +-+-+-+ + + +-+-+ + + + + +-+-+-+ + +-+-+ +-+-+-+
|   |   |     | | | |   |   |           |       | |   | | |   | |     |     | |   |   |   |   | | | | | | |     |       |   |   | |
+ + + + +-+ +-+-+ +-+-+ + +-+ +-+-+ + + +-+-+-+ +-+ +-+ +-+ + +-+-+ + +-+-+ +-+ +-+ +-+ +-+ +-+ + + +-+ + +-+-+-+-+-+-+ +-+-+ +-+ +
| | | |   | |           | | | |   | | | | |   |     |   | | |       |   | |     |     |   |     |   |   |   |     |     |     |   |
+ +-+ +-+-+ +-+-+ +-+ + + + + + + +-+ + + + +-+ +-+ + + + + +-+ +-+-+ +-+ + + + + +-+ +-+ + +-+ + +-+-+-+-+ +-+ + + +-+ + + +-+-+ +
|         |     | |   |       | | |   | |   | | |     | |   | |     |     | | |   |     | | | | | |     |   |   | | | |   |       |
+ + +-+ +-+ +-+-+ + +-+ + + + + +-+-+ +-+-+ + + +-+ +-+-+-+ + + +-+-+ +-+-+ +-+ +-+-+ + + +-+ + + + + + + + + +-+ +-+ +-+ + +-+-+ +
| | |   | |       | | | | | |   |     | |     | | |   |     |   |         | |       | | | |   |   | | |   |   |   |   |   |   |   |
+ + +-+ + +-+-+ + + + +-+-+-+ + +-+-+ + +-+ +-+-+ + +-+-+ +-+ +-+-+ + +-+-+-+-+ +-+ +-+ + + +-+-+ +-+ +-+ +-+ +-+-+-+ + +-+ + + +-+
| |   |         | | | |       | | | |             | |     | | |   | |   |     | |   |       |   | |   |   |           | |   | | | |
+ +-+-+-+-+ +-+ +-+ + + +-+-+-+ + + +-+ + + +-+-+ +-+ +-+ + + + + +-+ +-+ +-+ + +-+ + +-+-+ + +-+ +-+-+ +-+-+ + +-+-+-+-+ + + +-+ +
|     |     |     |   | |       |       | | |       | |   |     |   | |   |     |   | |         |         |   |     |     | |      
+-+-+-+-+-+-+-+-+-+-+-+-+-+-+-+-+-+-+-+-+-+-+-+-+-+-+-+-+-+-+-+-+-+-+-+-+-+-+-+-+-+-+-+-+-+-+-+-+-+-+-+-+-+-+-+-+-+-+-+-+-+-+-+-+-+
