+-+-+-+-+-+-+-+-+-+-+-+-+-+-+-+-+-+-+-+-+-+-+-+-+-+-+-+-+-+-+-+-+-+-+-+-+-+-+-+-+-+-+-+-+-+
            |   | | |   |     | |     |     | |   |   | |       | | | |     |       | |   |
+ +-+ + + +-+ +-+ + +-+ +-+-+ + + +-+-+ +-+-+ +-+ + +-+ + +-+-+ + + + + + +-+ +-+-+ + + + +
|   | | |           |     |     | |   |   |   | |       | |   |   |   | |     |   | | | | |
+-+ +-+ +-+-+-+ +-+ + +-+-+ +-+ + +-+ + +-+ +-+ +-+ +-+-+ + +-+ + +-+ + +-+-+-+ +-+ + +-+ +
|   |   |   |   |     |       | |           | |       |     |   |     |   |   | |         |
+-+ +-+ + +-+-+-+-+-+ +-+ + + + + +-+-+ +-+-+ + + +-+-+ + + +-+-+ +-+-+ +-+ +-+ +-+ + +-+ +
|   |     | | | | |       | | |     |   |       |       | | | |     |   |   |     | |   | |
+-+-+-+ +-+ + + + + +-+ + +-+ + + +-+-+ +-+-+ +-+-+-+-+ +-+-+ + +-+ + +-+-+ + +-+-+ + +-+-+
|   | |     |   |     | | | | | | |       |       | |     |   | |   |   | | | | |   |     |
+-+ + + +-+-+ +-+-+-+-+ + + +-+-+ + + + +-+-+-+ + + +-+ + + +-+-+-+-+-+-+ + + + + + +-+ + +
|         |     |       |     |   | | |       | | |   | |   |   |       | |       | | | | |
+-+-+-+-+-+ + +-+ +-+-+-+-+-+-+-+-+-+-+-+-+ +-+ + +-+ +-+ + + + + + + +-+ + + +-+ +-+ + +-+
| |     |   |       |           |   |     |     |       | |   | | | |       |   |   | |   |
+ + + +-+ +-+ +-+-+-+-+ +-+-+-+-+-+ + +-+-+ + + +-+-+-+-+ +-+-+ +-+-+-+-+-+-+-+-+ +-+ +-+-+
|   | | | |         |       | |   | |   |   | |   |   |     | |   | | |           |     | |
+-+-+ + + +-+-+-+-+-+-+ +-+-+ + + + +-+ +-+-+ +-+-+-+ + + + + + +-+ + +-+ +-+-+ + +-+-+ + +
|   |   |   |   |   | |   |   | |   | |   | | |       | | |   | | |     | |     |         |
+ +-+ + +-+ + +-+ +-+ +-+ + + + +-+ + + +-+ + + + + +-+-+ +-+-+-+ + +-+-+-+-+-+-+ +-+-+-+ +
|   | | |     |     |       | | | | |       | | | | |   | | |                 | |     | | |
+-+ + +-+ + +-+ +-+-+ + +-+ +-+-+ + + +-+ + + +-+ +-+ +-+-+ + + +-+ +-+-+ + + + + +-+-+ + +
|     | | |   |       |   | | | |     | | |   | |       |   | | |     | | | |   | |       |
+-+ + + +-+-+-+-+-+ +-+ + + + + + +-+-+ +-+ +-+ +-+-+-+ + + + +-+-+ +-+ +-+ + +-+-+-+-+ +-+
|   | |   | |       | | | |   | | |       |       |       | | |     |   | | | |     | |   |
+ +-+ +-+ + + +-+ + + +-+ + +-+ +-+ +-+-+-+ +-+ +-+-+-+ + +-+-+ + +-+ +-+ +-+-+-+ +-+ + + +
|   | | |     |   |   |   | | | |             |   | |   |       |       | | |       |   | |
+ +-+ + + + +-+ +-+-+-+-+ + + + +-+ +-+ +-+-+-+ +-+ + +-+ +-+ + + +-+ +-+ + + + +-+-+-+ +-+
| |   | | |   | |   |     | |         | | |   |   |   |     | | |   |   |     |           |
+ + +-+ + + + +-+-+ +-+ + + +-+-+ + + +-+ + +-+ +-+ +-+-+ +-+-+-+ + + + +-+-+-+-+ +-+-+ +-+
| |   |   | |         | | | |     | | | |   | |     |       |     | | |   |   |       | | |
+-+ + + + +-+ +-+ +-+-+ +-+-+-+-+ +-+-+ +-+ + +-+ +-+-+-+-+-+-+-+ + +-+-+ + +-+-+ +-+-+ + +
| | |   | |   | | |             |   |     |         | |     | | | |     | |       |     | |
+ +-+-+-+ + +-+ +-+-+ +-+-+ +-+-+ +-+ +-+ + + + +-+-+ + +-+-+ + +-+-+-+-+ + + + +-+-+ + + +
|   |     |   | | | | | | |     |   | | |   | |   |         | |       | | | | | | |   | | |
+ +-+-+ +-+ +-+ + + +-+ + +-+ +-+-+ + + + +-+-+ +-+ + + + +-+ +-+-+ +-+ + + +-+-+ +-+-+-+ +
| |   | |   |   | |   |             |   |     | |   | | | |       |   |   |         |     |
+ + +-+-+ +-+-+ + +-+ + + +-+-+ + + + + +-+ + + + +-+-+-+ +-+ +-+-+ +-+ +-+-+ + +-+ +-+ +-+
|     | | | | |   | | | |   |   | | | | |   | | | |     |       |   |       | | |   | | | |
+ + + + +-+ + +-+ + + + + + +-+-+-+-+-+-+ +-+-+-+-+ + +-+ + + + + +-+ + +-+ + +-+-+-+ + + +
| | | |     | | |   |   | | | |   |       |     |   |     | | |       | |       | |   |   |
+ +-+ + + + + + + + +-+-+ + + + +-+-+-+ + +-+-+ + +-+-+ + +-+-+-+-+ +-+ +-+ + + + + +-+ +-+
|   |   | |     | |   |   | |   |   |   |   |   |     | |       |   |   | | | | |         |
+ + + +-+-+-+-+ + +-+-+ + +-+ +-+ + +-+-+-+ + +-+-+-+-+-+ +-+ +-+ +-+ +-+ + +-+-+ +-+ + +-+
| | |   |         |   | |   | |   |     | | |   | |   | | |     |   |     |     | |   |   |
+ + + +-+-+-+-+ +-+ +-+-+ + + + + + + + + +-+ +-+ + +-+ +-+ + +-+ + +-+ +-+ +-+ + +-+-+-+ +
| | | |   |     |       | | | | | | | | |   |       |   | | | | | |   |   | |           | |
+-+ + + + +-+ + +-+-+-+ + +-+ +-+ + +-+-+ +-+-+-+ + + +-+ + + + +-+ +-+-+ +-+-+-+ +-+ +-+-+
|   | | |     | |     | | | |   | |     | | |     |   |     |     | |       |     | |     |
+-+-+ + +-+ +-+ + +-+ + + + + +-+ +-+-+-+ + + +-+-+ +-+ + +-+ +-+-+-+ + +-+-+-+-+ + +-+ +-+
|     |   | |       |             | | |   | | |         | | | | |   | |   | |   | |       |
+ +-+-+ +-+-+ + +-+-+ + +-+-+ +-+ + + +-+ + +-+ + + +-+ + + + + + + + +-+-+ + + + +-+-+ +-+
| |   |     | | |     | | | |   | |           | | | |   | |   |   |       |   |   |     | |
+-+ +-+ + +-+ +-+-+ + +-+ + + + + + +-+-+ +-+ + + +-+-+ + +-+-+-+-+-+-+ +-+-+-+-+-+-+-+ + +
|   |   |   |   | | | |       | | | |   |   | | |     | |         | |   |   | | |     |   |
+-+ +-+-+ +-+-+-+ +-+ +-+ +-+-+ +-+ + +-+-+-+ + +-+ + +-+-+-+-+ + + + +-+ + + + + + + +-+-+
|       |     | |       | | | |     |   | | | |   | | |     |   | |   |   |       | | | | |
+-+ + +-+ +-+-+ + +-+ + +-+ + + + + +-+ + + +-+ +-+-+-+-+ + + + +-+ + +-+-+ +-+-+-+-+-+ + +
|   |   | |     | | | |   | | | | | | | |     |   |   |   | | |   | |   | | |         | | |
+-+ +-+ + + +-+ + + +-+ + + + +-+-+-+ + + +-+-+ +-+ + +-+ +-+ +-+-+-+-+ + + + + + +-+-+ + +
| |   | | |   |   |     | |       | |   |   | | |   |   | |   |     |       | | | |       |
+ +-+-+ +-+-+-+-+ +-+-+-+ +-+ +-+ + + +-+-+ + +-+ +-+ +-+ + +-+ + + +-+-+-+-+-+ +-+ +-+-+-+
| |         | |   |   |     |   | |   | |     | |   | |         | | |   |     |         | |
+ +-+-+-+-+ + + +-+-+ + +-+ +-+-+ + +-+ + +-+-+ + +-+ + +-+-+ + +-+ + +-+-+ +-+ +-+ + +-+ +
| |   | |   | |     |   |       |     |       |   | |   |     |   |         | | | | |   | |
+ + + + + +-+ + + + +-+-+-+-+-+ + +-+-+-+-+ + +-+-+ + +-+-+ +-+ + + +-+-+-+ + + + + +-+ + +
| | | |       | | | |       |   | |   |     |   |       | |   | | | | |       | |   |   | |
+ +-+ +-+ + +-+-+ +-+ + +-+-+-+ + + + + +-+ + + +-+ +-+-+ +-+ +-+ +-+ +-+ + +-+-+-+-+-+ + +
| |       |   |       | |   | |     |   |   | | |         |     |   |   | | | | | |   |   |
+ + +-+-+-+ +-+-+ +-+-+ + + + + +-+ + + +-+-+-+-+ +-+-+-+-+-+-+-+-+ + + +-+ + + + + +-+ + +
| |     |       | |   |   | |     | | |   |   |   | |   | | | |   | | | |               | |
+ + +-+-+-+ +-+-+ + + +-+ +-+-+ +-+ + +-+ + + + +-+ +-+ + + + +-+ + + + + +-+ +-+-+ + +-+ +
| | | |       | |   | | |   |     | |   | | | |   |         |       | | |   | |   | | | | |
+ +-+ +-+-+ + + + +-+ + +-+-+ +-+ +-+-+-+-+ + + + + +-+-+-+ +-+-+ + + +-+-+ +-+ + + +-+ + +
| |     |   |   | | |   | |     | | |     | |   |   |     |   |   |     | | |   | | |   | |
+ +-+ + +-+ +-+ +-+ +-+-+ +-+ +-+ + +-+ +-+ + + + +-+ +-+ + +-+-+ +-+-+-+ + +-+ +-+ + + + +
|     |   | |   |           |   |       |   | | |   |   | | | | | | |   |   |       | | | |
+-+ +-+-+-+-+ +-+ + +-+ + +-+ +-+ +-+-+-+-+ + +-+-+ + +-+-+ + + + + + + + +-+-+-+ + + +-+-+
|   |     | | | | | |   | |     | |     | | | |     |   |     |   |   | | | |   | |       |
+-+ +-+ + + + + + + +-+ + +-+ + +-+-+ +-+ +-+-+-+ + + + +-+-+-+-+ +-+ +-+-+ + + + +-+-+-+ +
| |   | | |       |   | |   | | |   |             |   |     | | |     | |     |   | | |   |
+ +-+ + +-+ +-+ + + + + +-+ + +-+ + +-+-+-+ +-+ +-+ +-+-+ +-+ + + +-+ + +-+-+ +-+-+ + +-+ +
| |     |   |   | | | | |     | | | |   | | |   |     |       |   |   |     | |   |       |
+ + +-+ + +-+-+-+-+-+-+ + + + + + +-+ + + +-+-+-+-+-+ +-+ +-+-+ +-+ +-+-+ + +-+-+ +-+ + +-+
| |   | | | | | |       | | |   |     |   |   |     | |       |   |   |   |   |       |   |
+ + +-+ + + + + +-+-+ +-+-+-+-+ + +-+-+ +-+ +-+ +-+ + +-+-+-+-+-+-+-+ + +-+ +-+-+ +-+-+-+-+
|   | | |     |         | |     | |     | |     |     |       | |     | |       |   | |   |
+ + + + + +-+-+ +-+ + +-+ +-+ + + +-+-+-+ +-+-+-+-+ + +-+ +-+-+ +-+ + +-+-+-+ + +-+-+ + +-+
| | |     | | | |   | |   |   |               |     | | |   |     | | |   |   | |       | |
+-+ +-+ + + + +-+ +-+-+-+ +-+ +-+-+-+-+ +-+ +-+-+-+-+ + +-+ +-+-+ +-+ + +-+ + +-+ +-+ +-+ +
| | | | |     |     |       |     |       |   | |   | |       |     |   | | |   | |       |
+ + + +-+-+-+-+-+-+ +-+ + +-+-+-+-+ + +-+ +-+-+ + +-+ + + + +-+ +-+ + + + +-+ + + + + + + +
| |     | |   | | | |   | |   |   | |   |       |   |   | | | |   | | | |   | |   | | | | |
+ +-+ + + + +-+ + + + +-+ +-+ + + + + +-+ +-+-+ +-+ +-+-+ +-+ + +-+-+-+ +-+ + +-+-+-+ +-+-+
|     |     |   |   | |         |   | | | |         | |   |       |   | |         |     | |
+ + +-+ +-+-+ +-+-+-+ + +-+ + +-+-+ +-+ +-+ +-+ + +-+ + + +-+ +-+ + + +-+ +-+ +-+-+ +-+-+ +
| |   | |     | | |   | |   |     |     |   |   | |     | |   |     | |     |   |       | |
+-+-+ + +-+ + + + +-+-+-+-+-+-+-+ +-+ + +-+ + +-+-+ +-+ + +-+ +-+ + +-+-+ +-+-+ +-+ +-+ + +
| |   |     |   |           |       | | |   | |   |   | | |     | | |       |   | | |   | |
+ + +-+-+ +-+-+-+ + + + +-+-+-+ +-+-+-+-+ + +-+ + +-+-+-+ +-+-+ + +-+-+ +-+ +-+-+ + +-+-+ +
|   | |   |   |   | | | |     |   |     | |   | | |   |     |   |     | | | | | |     |   |
+ + + +-+-+ +-+-+-+-+ +-+ +-+ + +-+ +-+ + + +-+-+ + + +-+-+ + +-+-+-+ + + +-+ + +-+-+-+-+ +
| |   |       |           |     | | |   | |       | |   |         |             | |       |
+ + + + + +-+-+-+ +-+ +-+-+ +-+-+ +-+-+ +-+-+ + +-+-+-+ + +-+-+ + + +-+ +-+-+-+ + +-+-+-+ +
| | |   | |   | |   | | |       |     | |     |   |   | | |     | | |     |         | |   |
+-+ +-+ + +-+ + + +-+-+ +-+-+ +-+ +-+-+ +-+ + +-+-+-+ + +-+-+ + +-+ + + + +-+-+-+ +-+ +-+ +
| |   | | |     | | |           | | |     | |   | | | |     | |   | | | |   | | |         |
+ + + +-+-+-+-+ +-+ +-+ +-+ +-+-+ + +-+ +-+ +-+ + + + + + +-+-+-+ +-+ +-+ +-+ + +-+-+ +-+-+
|   | |   | |   |   |   |           | |   | |   |     | |     | | | | |   |   |           |
+-+-+-+-+ + +-+ +-+ + + + + +-+ + +-+ +-+ +-+-+-+ +-+ + + + +-+ +-+ +-+-+ +-+ +-+ +-+-+ +-+
|     | | |           | | |   | |   | |   |     | | | | | |               | |       |   | |
+-+ + + + + +-+ +-+-+ +-+ + + + +-+ + + + +-+-+ + + +-+-+-+ +-+ +-+ +-+ +-+ +-+-+-+-+ +-+ +
|   |       |   |       | | | | |     | | |         | |   | |     | | | |   | |     |     |
+ + +-+-+-+-+-+-+-+-+ +-+-+-+-+ + +-+ + +-+ +-+-+ +-+ + + + +-+ +-+ + + + +-+ +-+ +-+-+-+-+
| | |         |   |       |     |   |       | | |   |   | |   | | | |   |     |       |   |
+ +-+ + +-+ +-+ + +-+ + +-+ +-+-+-+-+ + + +-+ + +-+ +-+ +-+-+ +-+ +-+-+ +-+ +-+ +-+-+-+-+ +
|   | | |   | | |     | |   |     |   | | |       | |       | | | |     |           |     |
+-+-+-+ + + + + +-+-+-+ +-+-+-+ +-+-+-+ + + +-+-+ +-+-+ +-+-+ + + +-+-+ + +-+ +-+-+-+ +-+-+
|     | | | |       | | | | |           |   |     |                 |     |         |     |
+ +-+ +-+-+ + + +-+-+ + + + + + +-+ + +-+-+-+-+ +-+ +-+-+-+-+-+ + +-+-+-+-+-+-+ + +-+ +-+-+
| | | |       | |     |   |   | |   |   | |   | | | | | |     | | |   | |       | |     | |
+ + + + + +-+ +-+ + +-+-+-+ +-+ +-+-+-+ + + +-+-+ +-+ + + + + + +-+ + + + +-+ +-+ + + +-+ +
|   |   | |       | |       | |   |   |           |       | |       | | |   | | |   | |   |
+-+ +-+-+-+-+-+-+ + + + + + + +-+-+-+ +-+ +-+-+-+-+ +-+-+-+ +-+-+-+-+-+ + +-+ + + + + + + +
|     | |         | | | | | | | |   |     | |   | | |     | |   |   | |     |   | | | | | |
+-+-+ + +-+-+-+ +-+-+-+ + +-+ + +-+ +-+-+ + +-+ + +-+ +-+-+ + + +-+ + +-+ +-+-+-+-+ +-+ +-+
|       |     | |       |   |       |     | |     |     |     |       |     | | |         |
+-+ + +-+ +-+-+-+-+-+-+-+ +-+ +-+ + + + + + + +-+ +-+-+ + + +-+-+ + + +-+ +-+ + + + +-+-+ +
|   |   |         |     | |     | |   | |   |   | | |   | | |     | |   |       | | |   | |
+ +-+ + + +-+-+ +-+ + + +-+-+-+ + +-+ +-+-+ + +-+-+ + + + +-+-+ + +-+ +-+ +-+ +-+-+ + +-+ +
| |   |     |       | |     |   |   |     |   |       |   |     |   | |     |   |     |    
+-+-+-+-+-+-+-+-+-+-+-+-+-+-+-+-+-+-+-+-+-+-+-+-+-+-+-+-+-+-+-+-+-+-+-+-+-+-+-+-+-+-+-+-+-+
