+-+-+-+-+-+-+-+-+-+-+-+-+-+-+-+
  |     | |       |   |       |
+ + + +-+ + +-+ + + +-+ +-+-+-+
|   |   | |   | | |       | | |
+-+-+ + + + +-+ +-+-+-+-+ + + +
|     | | | |   |   | |   |   |
+-+ + + + + +-+ + +-+ + + +-+ +
|   | | |   |   |   |   | | | |
+-+-+-+ + +-+-+ + +-+-+ + + + +
|         | |     | | | |     |
+-+-+ +-+ + + +-+ + + + +-+-+ +
|     | | |   |   |     |     |
+ + +-+ + +-+-+-+ + +-+-+ +-+-+
| | |           |   | |       |
+ +-+-+ + +-+ +-+-+ + +-+ +-+ +
|   |   | | |     | |   |   | |
+-+-+ +-+-+ + +-+-+-+-+ + +-+-+
|       |   |     |   | |   | |
+ + + + +-+ +-+-+-+ +-+ +-+ + +
| | | |       | |         |   |
+-+ +-+ +-+-+ + +-+-+-+ +-+-+-+
|   |     | |   | |       |   |
+ +-+ + +-+ +-+-+ +-+-+ +-+ + +
|   | |       |   |   |     | |
+-+ + +-+ +-+-+ +-+-+ + + +-+ +
|   | | |   |     |   | | |   |
+ + +-+ + + +-+-+ + +-+ +-+-+-+
| | | |   |       |         | |
+-+-+ + +-+-+-+ +-+ +-+-+-+-+ +
|         | |     |   |     | |
+-+-+ +-+-+ + +-+-+ + + +-+-+ +
| |       | | |   | | |   |   |
+ +-+ +-+ + +-+ +-+-+ + + +-+ +
|       |     |   |     |   | |
+-+ +-+ + + +-+-+ + +-+ + + + +
|   |   | | | |       | | |   |
+-+ +-+-+ +-+ + +-+-+ +-+ + +-+
|     | | |   |   | | |   | | |
+-+ + + + + +-+-+ + +-+ + + + +
|   |   |   |     |   | | |   |
+-+ +-+ +-+-+ +-+ + +-+ + +-+ +
|   |   |     | | | | | | | | |
+-+ + +-+-+ +-+ + + + +-+-+ + +
|   | |     |     |   | | |   |
+ +-+ + +-+ + +-+-+ + + + + + +
|   |   | | |       | |   | | |
+-+-+ +-+ +-+-+-+ +-+-+ +-+-+ +
| |   |   | |           | |   |
+ + +-+ + + +-+-+-+ + +-+ +-+-+
|   |   |   |   |   | | | | | |
+-+ +-+-+ + + +-+-+-+ + + + + +
| | |     | |       |   |   | |
+ +-+-+-+ +-+-+-+ + +-+ + + + +
|     | |   |   | |   |   |   |
+ +-+ + + +-+-+ + +-+ + +-+-+-+
| | |   |   |       |   | |   |
+ + +-+ + +-+-+-+ +-+-+-+ + +-+
| | |   |         | | |       |
+ + + +-+-+ + + +-+ + + + +-+ +
| |         | |         |   |  
+-+-+-+-+-+-+-+-+-+-+-+-+-+-+-+
