+-+-+-+-+-+-+-+-+-+-+-+-+-+-+
  |       |   | |   | | | | |
+ +-+ + +-+ +-+ + +-+ + + + +
|     | |         |     |   |
+-+ + +-+-+-+ + +-+-+ + +-+ +
|   |     | | |   | | |   | |
+-+-+-+-+ + + +-+ + + + + + +
|     |       |   |   | | | |
+ +-+ +-+-+-+-+ +-+ +-+ + + +
| |   |   |   |   | |   | | |
+-+-+ + +-+ +-+ +-+ +-+-+-+ +
| |     | | |         | |   |
+ + +-+ + + + +-+-+-+ + + + +
|   |         | |         | |
+ + + +-+-+-+-+ +-+-+ +-+-+-+
| | | | |   |     |   |   | |
+-+-+ + +-+ + +-+ +-+ +-+ + +
|   |   |       |           |
+-+ + +-+-+-+-+-+-+-+-+-+ +-+
|       |     |     |     | |
+-+-+ +-+-+-+ + +-+ +-+-+-+ +
|     |   |       |       | |
+-+ +-+-+ +-+-+ +-+-+-+-+-+ +
|   | | |     | | |       | |
+-+ + + + +-+ + + + + + + + +
|       |   |       | | |   |
+-+ + + + +-+-+ +-+ + +-+ + +
|   | |     | | |   | | | | |
+-+-+ + +-+-+ +-+ + +-+ + +-+
| | | |   | |     | | |     |
+ + + +-+-+ + + + +-+ + +-+ +
|         |   | |   |   |    
+-+-+-+-+-+-+-+-+-+-+-+-+-+-+
