+-+-+-+-+-+-+-+-+-+-+-+-+-+-+-+-+-+-+-+-+-+-+-+-+-+-+-+-+-+-+-+-+-+-+-+
      |   |         |           |   | | | |         |   |   |       | |
+ +-+ + +-+-+ +-+ + + +-+ + + +-+ + + + + + +-+ +-+ +-+ + +-+-+-+ + + +
|   |   |   |   | | |   | | | |   |   | | | | | |             |   | | |
+-+-+ + + +-+-+-+ + +-+ +-+ +-+ + + + + + + + +-+ +-+ +-+ +-+ + +-+-+ +
|     | | | |     |     |   |   | | |   | | | |   |     | |   |       |
+-+-+ +-+ + +-+-+-+ +-+-+-+-+ +-+-+-+-+ + + + +-+ +-+-+-+-+ + +-+-+ + +
|   |         |   |       |       |       |   | | |     |   |       | |
+-+ + + +-+-+-+ +-+-+-+ +-+-+-+-+ +-+-+-+-+-+-+ +-+ +-+-+ + +-+ +-+ +-+
| |   | | | | |     | |   | | | |   | |     |   |       | |   | | | | |
+ +-+ + + + + + +-+-+ +-+ + + + + +-+ +-+ + + +-+-+-+ + +-+ +-+-+ + + +
|   | |   |       | | |         |   |   | | |         | | |   |   | | |
+ +-+ + +-+ + + + + + +-+-+ +-+ +-+ + +-+ +-+ +-+-+-+ +-+ + +-+ +-+-+ +
|     |     | | |     | |   |   | |   |   | |     |     | |       | | |
+ + +-+-+-+ +-+-+-+-+ + +-+-+-+ + + +-+ +-+ +-+-+-+-+-+ + + +-+-+ + + +
| |   | |           | | |     | |   |                 |     | |       |
+ +-+-+ + + + + +-+ +-+ + +-+-+ +-+ + + +-+ +-+-+-+-+ + + +-+ +-+ + + +
|   |   | | | | | | |   |     | |     | |       |     | |     |   | | |
+ +-+ +-+ +-+-+ + +-+-+ + +-+-+ +-+-+-+-+-+-+-+ +-+-+-+ +-+-+ + +-+ + +
| |           | |   |                 |     | |     |   | |   | | | | |
+-+-+-+-+ +-+-+ +-+ + +-+-+ + +-+ +-+-+-+-+ + + +-+-+ +-+ +-+-+-+ + +-+
| |   |       |     |     | | | |         | |   |     | |     |   | | |
+ +-+ + + +-+-+-+ +-+-+ + +-+ + + +-+-+-+-+ + +-+ +-+-+ +-+ +-+ +-+ + +
|   |   |     |       | | |   | |   |   | | |       |         | | |   |
+ +-+-+ + + +-+-+-+ +-+-+-+-+-+ +-+ + +-+ + + + + +-+-+ +-+-+ + + +-+ +
| | |   | | | |           |   | | |     |     | |       | |       | | |
+ + + + +-+ + +-+-+-+-+-+ +-+ + + +-+ +-+ + + +-+-+-+ +-+ +-+-+-+ + + +
|   | | |   |       | |   |         |     | |     |     |   | |     | |
+ + +-+ + + +-+-+ +-+ + + + +-+ +-+-+ + + +-+-+ +-+ + +-+ +-+ + + +-+-+
| |     | |     |     | | | |     |   | | | |     | | | |   | | |     |
+ +-+-+-+-+ + + + +-+ +-+ + +-+-+-+-+-+-+ + + +-+ +-+-+ + +-+ +-+ +-+-+
|   | | |   | | |   | |   |   |   | |   | |   | | |     |         |   |
+ +-+ + + + + + + + + + + + +-+-+ + +-+ +-+-+-+ + + +-+-+ +-+ +-+-+ +-+
| |     | | | |   | | | |   |     |     |   | |   | |   | | | | |     |
+ + + + +-+-+ + +-+-+ +-+ +-+ +-+ + +-+ + +-+ +-+ + + +-+ + + + + +-+-+
| | | |   |   |   |   |       |   |   |   |   |     |   | | |         |
+ + +-+-+-+ + +-+-+-+-+ +-+-+-+-+ +-+-+ +-+ +-+-+-+ +-+ + + + + + + +-+
| | |   |   | | |   | | |           | |           |     | |   | | | | |
+ + +-+ +-+-+ + + +-+ + +-+-+-+-+ +-+ +-+ +-+-+-+ + + + +-+ + +-+ +-+ +
|     |   | | |   |     |     |   | | |       | |   | | | | |   | |   |
+-+ +-+-+ + +-+ + +-+ + + +-+-+-+-+ + +-+ + + + +-+-+-+-+ +-+ +-+-+ + +
|   |       |   | |   | | | |             | |           |   | | |   | |
+-+ + +-+-+ +-+-+ + +-+-+ + +-+ + +-+-+ +-+-+ + +-+-+ +-+ +-+-+ +-+ + +
|   | | | |   | | |         |   | |     |   | |     |   |   | |     | |
+ +-+-+ + + +-+ + +-+-+ +-+-+-+-+-+-+-+ + +-+ +-+-+ + + + + + +-+ + + +
| | | |   |     |           |   |   |     |   |   | | |   |       | | |
+-+ + +-+ +-+ + + + + +-+-+-+-+ + +-+-+ +-+-+-+ + +-+ +-+-+-+-+-+ +-+-+
| | |       | |   | |   |       |   |     |     |   | |   |           |
+ + +-+ +-+-+ +-+-+-+-+ + +-+ + + + + +-+ + + + +-+ +-+ + +-+ +-+-+ +-+
|     |     |   | |   |   | | |   | |   |   | |   | |   | | |   |     |
+ +-+-+-+-+ +-+ + +-+ + +-+ +-+-+ +-+ + +-+-+ +-+-+-+-+-+ + +-+-+-+ + +
|   |           |     | |     |       |     |     |         |       | |
+-+ + +-+-+-+-+ + + +-+ + + +-+-+-+ +-+ +-+ +-+-+ +-+-+-+-+ + +-+ + + +
|     |       | | |     | |           | |   |           |       | | | |
+-+-+-+-+-+ +-+-+-+ +-+ +-+ + + +-+ + +-+ +-+-+-+-+-+ + +-+ + +-+-+ +-+
|     |     | |   | |     | | | | | |   |         |   |   | | | |   | |
+ +-+-+-+-+ + + + +-+-+-+-+ +-+ + +-+ +-+ +-+ +-+ +-+-+ + + + + +-+-+ +
|       |       | | |   | | |   |   | |   | |   |     | | | |         |
+-+ + +-+ + + +-+ + +-+ + +-+-+ + +-+-+ +-+ + + +-+-+ +-+-+-+-+ + +-+-+
| | |     | | |         | |           | |   | |   | | |     | | | |   |
+ + +-+-+ +-+-+-+ +-+-+ + +-+ +-+-+-+ +-+-+ +-+-+-+ +-+ +-+-+ +-+ +-+ +
| |   |     |     | |   |     |   |   |               | |   |   |     |
+ + + +-+-+-+ +-+-+ + + +-+-+-+ +-+ +-+ + +-+-+-+-+-+-+ + +-+ + + +-+ +
|   |     | | |       | |   |       | | |   |     | |     |   | | |   |
+-+ +-+-+ + +-+-+ +-+-+ + +-+-+ + +-+ + +-+-+ + +-+ +-+-+ + +-+ +-+-+-+
|     |   | |   |   |   |       |     |     | | |           |   |     |
+-+ + +-+-+ + +-+ + +-+ +-+-+-+-+-+ + +-+ + + + +-+ +-+ +-+ + +-+ + +-+
|   | | | |       |   | | |   |     |   | | | |       |   | | |   |   |
+-+ +-+ + + + +-+ +-+-+-+ +-+ +-+-+ +-+-+-+ +-+-+-+ + + +-+-+ + +-+ +-+
| | |   |   | |       | | | |           |     |   | | |   | |     |   |
+ + + + +-+-+ + + +-+-+ + + +-+ +-+-+-+ + + + + +-+ +-+ + + +-+ + + + +
| |   | |   | | | |             | |       | | |   | |   | |     | | | |
+ + +-+-+ + +-+-+ + +-+ + +-+-+-+ + +-+-+-+-+ +-+ + +-+-+ + +-+ +-+-+ +
| | |   | |         |   |   |       | |   | |     |     | | | | | |   |
+ +-+-+ + + +-+-+-+-+ +-+ +-+-+-+-+ + +-+ + +-+ +-+ + + + + + +-+ +-+ +
|   |     | | |         | | | | | |     |     | |   | | | | |   | | | |
+-+ + + +-+-+ +-+ + +-+-+ + + + + +-+-+-+ +-+ +-+ + +-+-+ +-+ +-+ + +-+
|     |     | | | | |           |     | | |   |   | | |       |   |   |
+-+-+ + + + + + +-+-+ +-+-+ +-+ +-+-+ + +-+-+ + +-+-+ + + +-+-+ +-+ + +
|   | | | | |   |   |   | | | | |     | |         | |   |     | | | | |
+-+ + +-+-+-+-+ +-+ + + + + + +-+ +-+-+ + +-+ + +-+ +-+ +-+ +-+ + + + +
| |     | |         | | |       |         | | | |   |     | | |   | | |
+ + + +-+ + +-+ +-+-+ +-+-+-+-+ +-+ +-+-+ + +-+-+-+ +-+ +-+-+ + +-+ + +
| | | |   |   |   | |     |   |   | |     |             |     |     | |
+ + + + +-+ +-+-+ + + +-+ + +-+-+-+-+ + +-+-+-+-+ + +-+ +-+-+ + +-+-+ +
|   | |     | | |       |         |   | | |       |   | |       |   | |
+ +-+ +-+ + + + +-+-+-+-+ + +-+-+-+-+-+ + +-+-+ +-+-+-+-+ +-+-+ + + + +
| |   |   | |   |   | | | |     | | | |       |   |   |   |       | | |
+ +-+ + +-+ + +-+ +-+ + + + +-+ + + + + +-+ + + + +-+ + +-+ +-+ +-+-+ +
|   | | |     |   |   |   | |           | | | | | |       | |     | | |
+-+ +-+-+ + + + +-+ +-+-+-+-+-+ +-+ +-+ + + +-+-+-+-+ +-+ +-+-+ +-+ + +
|   | |   | |     |       |   | |   |   |     |     |   | |   | |   | |
+ +-+ +-+-+-+-+-+ +-+-+ +-+-+ + +-+ +-+ +-+-+ +-+ +-+-+ +-+ +-+-+ + + +
|       |         |       | |   |   |   |       |   |   |   |   | | | |
+ +-+-+-+-+-+ +-+ + + + +-+ +-+-+ +-+-+-+-+ +-+-+-+ +-+-+ + +-+ + + + +
| |   | |     |   | | |   |       | |     |         |     | |     |   |
+-+ +-+ +-+ +-+ + + +-+-+-+-+ +-+-+ +-+ + +-+-+-+-+-+ +-+ + +-+-+-+-+ +
|     | |     | |         |   |       | | |   |     |   | |   |       |
+-+-+ + + +-+ +-+-+-+ + +-+ + +-+ +-+-+ +-+ +-+ + +-+ + +-+ +-+ + +-+-+
|   | |     | |   | | | | | |     |       |     | | | | | |     |     |
+ +-+ +-+-+-+ + +-+ + +-+ +-+ +-+-+ +-+-+ + +-+-+-+ + +-+ +-+-+ +-+ +-+
| |         |       | |     |         | | |   |   |   | | |   |   | | |
+ + +-+-+-+-+-+-+-+-+ +-+ +-+-+ +-+-+ + + + +-+ +-+-+-+ + + +-+-+-+ + +
|       |   | |           | |   |     |     |       | | |     |     | |
+-+ +-+-+ +-+ + + +-+-+-+-+ + +-+-+ + +-+-+-+-+ + +-+ + + +-+ + +-+ + +
| |   |     |   |     |       |   | |   |     | | |     | | |     |   |
+ +-+ +-+-+ + +-+-+ +-+-+ +-+ + +-+ + +-+-+-+ + +-+-+ + + + +-+-+-+ + +
|               |   | | | |   | |   |   | |   |   |   | | |   |     | |
+-+-+ +-+-+-+ +-+-+ + + + +-+ + +-+-+-+ + +-+ + + +-+ +-+-+-+ +-+-+-+ +
|   |   | |     |       |   | |   |   | | | |   | |   |     |         |
+ +-+-+-+ + +-+ +-+-+ +-+-+-+ + +-+-+ + + + + +-+ + +-+-+-+ + + +-+-+ +
|       | | | |   |   |               | |       |   |     | | |     | |
+ +-+-+ + +-+ +-+ +-+ +-+ +-+-+ +-+-+ +-+-+-+-+-+ +-+ +-+-+ + + +-+ +-+
| |               |   | |   |     | |     |       |       |   | |   | |
+-+ +-+ +-+-+-+-+ +-+-+ + + +-+-+ + +-+-+ +-+ +-+ + +-+-+ + +-+-+-+-+ +
|     |     | | |   |   | |   |     |         |     |   |             |
+ +-+ + + +-+ + +-+ + + +-+-+ + + +-+ +-+ + +-+-+ +-+ +-+ +-+-+-+ + + +
|   | | |   | |     | |   | | | |   | |   | | |       | | |     | | | |
+ +-+-+ +-+ + +-+ +-+-+ + + + +-+ +-+-+-+-+-+ +-+ +-+-+ +-+-+-+ + +-+-+
|     |   |     | | |   |       |   | | |     |     |           |     |
+ + + +-+-+ +-+-+-+ + +-+ +-+-+ + +-+ + + +-+-+-+-+-+-+ +-+ +-+-+-+ +-+
| | |   |       | | |   | |     | | |               | |   |     |   | |
+ +-+ + +-+-+-+-+ + + +-+-+ +-+-+-+ + +-+-+ +-+ +-+-+ +-+-+ +-+-+-+ + +
| | | | |                 |     |   |   |     |       | |   | | |     |
+-+ + +-+-+-+-+ +-+-+-+ + + +-+ +-+ +-+-+ +-+ + +-+ +-+ + + + + +-+-+ +
|   |   |     |     |   | |   |     |     |   |   |     | |       |   |
+ + + +-+-+ +-+-+-+ +-+-+ +-+-+-+ + + +-+-+-+ + +-+-+-+ + +-+-+-+-+-+ +
| |           | |     | | |       |       |   | |     | |   |         |
+-+ +-+-+-+ +-+ +-+ + + +-+-+-+-+-+-+-+ +-+-+-+ + +-+ + + + +-+ +-+-+ +
|       |       |   |   |                 |         | |   | |   |      
+-+-+-+-+-+-+-+-+-+-+-+-+-+-+-+-+-+-+-+-+-+-+-+-+-+-+-+-+-+-+-+-+-+-+-+
